{
  "alice": {
    "V0": "V3",
    "V7": "V2",
    "V2": "V11",
    "V12": "V12",
    "V1": "V5",
    "V3": "V7",
    "V4": "V1",
    "V6": "V8",
    "V9": "V6",
    "V10": "V0",
    "V8": "V10",
    "V11": "V9",
    "V5": "V4"
  },
  "emily": {
    "A0": "A2",
    "A1": "A1",
    "A2": "A3",
    "A3": "A4",
    "A4": "A0"
  },
  "john": {
    "X6": "X1",
    "X5": "X4",
    "X4": "X3",
    "X7": "X6",
    "X2": "X2",
    "X1": "X0",
    "X3": "X5",
    "X0": "X7"
  }
}